########################
..######################
....###################.
.....#...#...#...#...#..
........................
.....#...#...#...#...#..
########################