........................
........................
........................
........................
........................
....#........F...T....B.
########################