.......................
........................
........................
........................
........................
.......F..T..B..G..G....
########################