........................
........................
........................
...GGG......G...G...G...
..G.......#####.#.####..
.....##########.#.######
###############.#.######