........................
........................
........................
...GGG......G...M...G...
..G.......#####.#.####..
.....#####/////././///##
#####//////////././/////