........................
........................
........................
........................
..........G.............
.....G.......F.G.T....B.
########################