.......................
........................
........................
........................
........................
............F...........
########################