........................
.........GG.............
......GG...#############
...GG...################
.....###################
..######################
########################