........................
........................
#####...........########
#######.......##########
########################
########################
########################