.......................
........................
........................
........................
........................
...............B........
########################