........................
........................
...............G..G..G..
.........G...##########.
....G..####.............
...########.......GG....
################.####.##