........................
.........GG............M
......GG...#############
...GG...################
.....###################
..######################
########################