........................
........................
........................
........................
..........#####.#.####..
.....##########.#.######
###############.#.######