........................
........................
#####...........########
#######.GGGGG.##########
########################
########################
########################