........................
........................
........................
........................
........................
.............F...T....B.
########################