........................
........................
...............G..M..G..
.........G...##########.
....G..####.............
...########.......GG....
################.####.##