.......................
........................
........................
........................
........................
.......F..T..B..G..G...O
########################
