........................
........................
............GG..........
...........G..G.........
.....#######..######....
...#########..########..
############..##########