.......................
........................
........................
........................
........................
.......G..G..G..G..G...O
########################