........................
........................
........................
........................
.....#######..######....
...#########..########..
############..##########