........................
...........#####........
......##########........
################........
################........
################........
########################