........................
.........GG............M
......GG...#############
...GG...###/////////////
.....###////////////////
..###///////////////////
##//////////////////////