........................
........................
...........#############
........################
.....###################
..######################
########################