........GGGGG...........
.....................G..
####..##########.....G..
////..//////////###..G..
////............///.....
////.......GGG..........
////####################