........................
........................
............GG..........
...........G..G.........
.....#######..######....
...##///////..//////##..
###/////////..////////##