........................
........................
####..##########........
####..#############.....
####............###.....
####....................
########################