
........................
........................
........................
........................
..............T..T......
..............T..T......
########################