........................
........................
#####...........########
/////##.GGGGG.##////////
///////#######//////////
////////////////////////
////////////////////////