........................
........................
........................
.............##########.
.......####.............
...########.............
################.####.##