........................
........................
........................
........................
........................
........................
........................
........................
........................
........................
........................
...................##...
..............##........
........................
########################