........................
........................
........####............
########################
########################
