........................
........................
........................
.###....................
........................
........................
........................
#########..##...........
........................
........................
........................
........................
........................
........................
###....###....####....##